1 1 1 1 1 1 1 1 1 1 1 1 1 1 1 1 1 1 1 1 1 1 1 1 1 1 1 1 1 1 1 1 1 1 1 1 1 1 1 1 1 1 1 1 1 1 1 1 1 1
1 0 4 5 2 3 0 4 5 2 3 0 4 5 2 3 0 4 5 2 3 0 4 5 2 3 0 4 5 2 3 0 4 5 2 3 0 4 5 2 3 0 4 5 2 3 0 4 5 1
1 0 4 5 2 3 0 4 5 2 3 0 4 5 2 3 0 4 5 2 3 0 4 5 2 3 0 4 5 2 3 0 4 5 2 3 0 4 5 2 3 0 4 5 2 3 0 4 5 1
1 0 4 5 2 3 0 4 5 2 3 0 4 5 2 3 0 4 5 2 3 0 4 5 2 3 0 4 5 2 3 0 4 5 2 3 0 4 5 2 3 0 4 5 2 3 0 4 5 1
1 0 4 5 2 3 0 4 5 2 3 0 4 5 2 3 0 4 5 2 3 0 4 5 2 3 0 4 5 2 3 0 4 5 2 3 0 4 5 2 3 0 4 5 2 3 0 4 5 1
1 5 5 5 5 5 5 5 5 5 5 5 5 5 5 5 5 5 5 5 5 5 5 5 5 5 5 5 5 5 5 5 5 5 5 5 5 5 5 5 5 5 5 5 5 5 5 5 5 1
1 0 4 5 2 3 0 4 5 2 3 0 4 5 2 3 0 4 5 2 3 0 4 5 2 3 0 4 5 2 3 0 4 5 2 3 0 4 5 2 3 0 4 5 2 3 0 4 5 1
1 0 4 5 2 3 0 4 5 2 3 0 4 5 2 3 0 4 5 2 3 0 4 5 2 3 0 4 5 2 3 0 4 5 2 3 0 4 5 2 3 0 4 5 2 3 0 4 5 1
1 0 4 5 2 3 0 4 5 2 3 0 4 5 2 3 0 4 5 2 3 0 4 5 2 3 0 4 5 2 3 0 4 5 2 3 0 4 5 2 3 0 4 5 2 3 0 4 5 1
1 0 4 5 2 3 0 4 5 2 3 0 4 5 2 3 0 4 5 2 3 0 4 5 2 3 0 4 5 2 3 0 4 5 2 3 0 4 5 2 3 0 4 5 2 3 0 4 5 1
1 0 4 5 2 3 0 4 5 2 3 0 4 5 2 3 0 4 5 2 3 0 4 5 2 3 0 4 5 2 3 0 4 5 2 3 0 4 5 2 3 0 4 5 2 3 0 4 5 1
1 0 4 5 2 3 0 4 5 2 3 0 4 5 2 3 0 4 5 2 3 0 4 5 2 3 0 4 5 2 3 0 4 5 2 3 0 4 5 2 3 0 4 5 2 3 0 4 5 1
1 0 4 5 2 3 0 4 5 2 3 0 4 5 2 3 0 4 5 2 3 0 4 5 2 3 0 4 5 2 3 0 4 5 2 3 0 4 5 2 3 0 4 5 2 3 0 4 5 1
1 0 4 5 2 3 0 4 5 2 3 0 4 5 2 3 0 4 5 2 3 0 4 5 2 3 0 4 5 2 3 0 4 5 2 3 0 4 5 2 3 0 4 5 2 3 0 4 5 1
1 0 4 5 2 3 0 4 5 2 3 0 4 5 2 3 0 4 5 2 3 0 4 5 2 3 0 4 5 2 3 0 4 5 2 3 0 4 5 2 3 0 4 5 2 3 0 4 5 1
1 0 4 5 2 3 0 4 5 2 3 0 4 5 2 3 0 4 5 2 3 0 4 5 2 3 0 4 5 2 3 0 4 5 2 3 0 4 5 2 3 0 4 5 2 3 0 4 5 1
1 0 4 5 2 3 0 4 5 2 3 0 4 5 2 3 0 4 5 2 3 0 4 5 2 3 0 4 5 2 3 0 4 5 2 3 0 4 5 2 3 0 4 5 2 3 0 4 5 1
1 0 4 5 2 3 0 4 5 2 3 0 4 5 2 3 0 4 5 2 3 0 4 5 2 3 0 4 5 2 3 0 4 5 2 3 0 4 5 2 3 0 4 5 2 3 0 4 5 1
1 0 4 5 2 3 0 4 5 2 3 0 4 5 2 3 0 4 5 2 3 0 4 5 2 3 0 4 5 2 3 0 4 5 2 3 0 4 5 2 3 0 4 5 2 3 0 4 5 1
1 0 4 5 2 3 0 4 5 2 3 0 4 5 2 3 0 4 5 2 3 0 4 5 2 3 0 4 5 2 3 0 4 5 2 3 0 4 5 2 3 0 4 5 2 3 0 4 5 1
1 2 2 2 2 2 2 2 2 2 2 2 2 2 2 2 2 2 2 2 2 2 2 2 2 2 2 2 2 2 2 2 2 2 2 2 2 2 2 2 2 2 2 2 2 2 2 2 2 1
1 0 4 5 2 3 0 4 5 2 3 0 4 5 2 3 0 4 5 2 3 0 4 5 2 3 0 4 5 2 3 0 4 5 2 3 0 4 5 2 3 0 4 5 2 3 0 4 5 1
1 0 4 5 2 3 0 4 5 2 3 0 4 5 2 3 0 4 5 2 3 0 4 5 2 3 0 4 5 2 3 0 4 5 2 3 0 4 5 2 3 0 4 5 2 3 0 4 5 1
1 0 4 5 2 3 0 4 5 2 3 0 4 5 2 3 0 4 5 2 3 0 4 5 2 3 0 4 5 2 3 0 4 5 2 3 0 4 5 2 3 0 4 5 2 3 0 4 5 1
1 0 4 5 2 3 0 4 5 2 3 0 4 5 2 3 0 4 5 2 3 0 4 5 2 3 0 4 5 2 3 0 4 5 2 3 0 4 5 2 3 0 4 5 2 3 0 4 5 1
1 0 4 5 2 3 0 4 5 2 3 0 4 5 2 3 0 4 5 2 3 0 4 5 2 3 0 4 5 2 3 0 4 5 2 3 0 4 5 2 3 0 4 5 2 3 0 4 5 1
1 0 4 5 2 3 0 4 5 2 3 0 4 5 2 3 0 4 5 2 3 0 4 5 2 3 0 4 5 2 3 0 4 5 2 3 0 4 5 2 3 0 4 5 2 3 0 4 5 1
1 3 3 3 3 3 3 3 3 3 3 3 3 3 3 3 3 3 3 3 3 3 3 3 3 3 3 3 3 3 3 3 3 3 3 3 3 3 3 3 3 3 3 3 3 3 3 3 3 1
1 0 4 5 2 3 0 4 5 2 3 0 4 5 2 3 0 4 5 2 3 0 4 5 2 3 0 4 5 2 3 0 4 5 2 3 0 4 5 2 3 0 4 5 2 3 0 4 5 1
1 0 4 5 2 3 0 4 5 2 3 0 4 5 2 3 0 4 5 2 3 0 4 5 2 3 0 4 5 2 3 0 4 5 2 3 0 4 5 2 3 0 4 5 2 3 0 4 5 1
1 0 4 5 2 3 0 4 5 2 3 0 4 5 2 3 0 4 5 2 3 0 4 5 2 3 0 4 5 2 3 0 4 5 2 3 0 4 5 2 3 0 4 5 2 3 0 4 5 1
1 0 4 5 2 3 0 4 5 2 3 0 4 5 2 3 0 4 5 2 3 0 4 5 2 3 0 4 5 2 3 0 4 5 2 3 0 4 5 2 3 0 4 5 2 3 0 4 5 1
1 0 4 5 2 3 0 4 5 2 3 0 4 5 2 3 0 4 5 2 3 0 4 5 2 3 0 4 5 2 3 0 4 5 2 3 0 4 5 2 3 0 4 5 2 3 0 4 5 1
1 0 4 5 2 3 0 4 5 2 3 0 4 5 2 3 0 4 5 2 3 0 4 5 2 3 0 4 5 2 3 0 4 5 2 3 0 4 5 2 3 0 4 5 2 3 0 4 5 1
1 0 4 5 2 3 0 4 5 2 3 0 4 5 2 3 0 4 5 2 3 0 4 5 2 3 0 4 5 2 3 0 4 5 2 3 0 4 5 2 3 0 4 5 2 3 0 4 5 1
1 0 4 5 2 3 0 4 5 2 3 0 4 5 2 3 0 4 5 2 3 0 4 5 2 3 0 4 5 2 3 0 4 5 2 3 0 4 5 2 3 0 4 5 2 3 0 4 5 1
1 0 4 5 2 3 0 4 5 2 3 0 4 5 2 3 0 4 5 2 3 0 4 5 2 3 0 4 5 2 3 0 4 5 2 3 0 4 5 2 3 0 4 5 2 3 0 4 5 1
1 0 4 5 2 3 0 4 5 2 3 0 4 5 2 3 0 4 5 2 3 0 4 5 2 3 0 4 5 2 3 0 4 5 2 3 0 4 5 2 3 0 4 5 2 3 0 4 5 1
1 1 1 1 1 1 1 1 1 1 1 1 1 1 1 1 1 1 1 1 1 1 1 1 1 1 1 1 1 1 1 1 1 1 1 1 1 1 1 1 1 1 1 1 1 1 1 1 1 1